**************************************************
********************        **********************
********************        **********************
********************        **********************
***********                            ***********
***********                            ***********
*                                               **
*                                               **
*                                               **
*             **********************            **
*             **********************            **
*             **********************            **
*             **********************            **
*                                               **
*                                               **
***                                            ***
*****            **************           ********
************                         *************
*****                                    *********
**************************************************
